...###
..##.#.###*
.##0.*##..#
##........#
#......#..#
###..###..#
..#..#..*.#
.##.##.#.##
.#.@....##
.#..*..##
.#######