...###
..##.0.####
.##*..##..#
##........#
#...@..*..#
###......*#
..#.......#
.##.*..#.##
.#......##
.#..*..##
.#######