...###
..##.#.####
.###*###.0#
##.#......#
#*.#@..#*.#
####.###..#
..#..#....#
.##.##.#.##
.#..*...##
.#.....##
.#######