...###
..##.#.####
.##*.###.0#
##........#
#*..@..#..#
###.....*.#
..#..#....#
.##.##.#.##
.#.*....##
.#...*.##
.##.....